00020002000200020002000200020002000200020002000200020002000200020002000200020002
00220000000000000000000000000000000000000000000000000000000000000000000000000022
00220000000000000000000000000000000000000000000400000000000000000000000000000022
00220000000000000000000000000000000000000000000000000000000000000000000000000022
00220000000000000000000000000000000000000000000000000000000000000000000000000022
00220000000000000000000000000000000000000000000000000000000000000000000400000022
00220000000000000000000000040004000400040000000000000000000000000000000000000022
00220000000000000000001300210021002100210013000000000000000000000000000000000022
00220000000000000000000000110011001100110000000000000000000400000000000000000022
00220000000000000000000000000000000000000000000000000000000000000000000000000022
00220000000000000000000000000000000000000000000000000000000000000000000000000002
00220016000000000000000000000000000000000000000000000000000000000000000000020002
00020002000200000000000000000000000000000000000000000016000000020002000200020002
00020002000200020002000200000000001600000000000000020002000200020002000200020002
00020002000200020002000200020002000200020002000200020002000200020002000200020002
texture[0808]=C:\Users\deben_000\Desktop\terrain.png